NO maps/texture.xpm
SO maps/texture.xpm
WE maps/texture.xpm
EA maps/texture.xpm

F 220,100,0
C 225,30,0

111111111111111
100000000000001
101111110000001
101111110000001
100000000000001
111111111111111

This is ignored